NO ./sprites/north.xpm
EA ./sprites/coloredstone.xpm
SO ./sprites/stone.xpm
WE ./sprites/brick.xpm

F 0,100,100
C 100,200,1

11111111111
    10100111
    110000111
    10000111
    100000111
    100000111
    100000111
    100000111
    100000111
    10000000111
    100000111
    100000011
    100000111
    100000111
    100000111
    100000111
    100000111
    100000111
    100000111
    100000111
    1W0001111
1111111111